"filename", "language", "GLSL", "Java", "comment", "blank", "total"
"d:\GitRepos\ics4-final-project-ibihaqs\assets\shaders\default.glsl", "GLSL", -4, 0, 0, 2, -2
"d:\GitRepos\ics4-final-project-ibihaqs\src\main\java\engine\AssetManager.java", "Java", 0, 15, 18, 8, 41
"d:\GitRepos\ics4-final-project-ibihaqs\src\main\java\engine\Inputs\BoolState.java", "Java", 0, -2, 34, 0, 32
"d:\GitRepos\ics4-final-project-ibihaqs\src\main\java\engine\Inputs\Input.java", "Java", 0, -1, 49, 1, 49
"d:\GitRepos\ics4-final-project-ibihaqs\src\main\java\engine\Inputs\InputAxis.java", "Java", 0, 13, 84, 1, 98
"d:\GitRepos\ics4-final-project-ibihaqs\src\main\java\engine\Inputs\KeyListener.java", "Java", 0, -5, 55, -2, 48
"d:\GitRepos\ics4-final-project-ibihaqs\src\main\java\engine\Inputs\MouseListener.java", "Java", 0, -5, 62, 3, 60
"d:\GitRepos\ics4-final-project-ibihaqs\src\main\java\engine\Window.java", "Java", 0, 36, -3, 9, 42
"d:\GitRepos\ics4-final-project-ibihaqs\src\main\java\engine\components\Component.java", "Java", 0, 0, 3, 0, 3
"d:\GitRepos\ics4-final-project-ibihaqs\src\main\java\engine\components\Renderable.java", "Java", 0, 4, 0, 3, 7
"d:\GitRepos\ics4-final-project-ibihaqs\src\main\java\engine\components\SpriteRenderer.java", "Java", 0, 1, 8, -3, 6
"d:\GitRepos\ics4-final-project-ibihaqs\src\main\java\engine\components\Transform.java", "Java", 0, 2, 0, 1, 3
"d:\GitRepos\ics4-final-project-ibihaqs\src\main\java\engine\gameobjects\GameObject.java", "Java", 0, 0, 36, -4, 32
"d:\GitRepos\ics4-final-project-ibihaqs\src\main\java\engine\geometry\Circle.java", "Java", 0, 25, 28, 29, 82
"d:\GitRepos\ics4-final-project-ibihaqs\src\main\java\engine\geometry\Quad.java", "Java", 0, 13, 22, 27, 62
"d:\GitRepos\ics4-final-project-ibihaqs\src\main\java\engine\physics\Collision.java", "Java", 0, -58, 58, 0, 0
"d:\GitRepos\ics4-final-project-ibihaqs\src\main\java\engine\renderer\EBO.java", "Java", 0, -1, 0, 0, -1
"d:\GitRepos\ics4-final-project-ibihaqs\src\main\java\engine\renderer\Layer.java", "Java", 0, 8, 10, 4, 22
"d:\GitRepos\ics4-final-project-ibihaqs\src\main\java\engine\renderer\RenderBatch.java", "Java", 0, 14, 3, 8, 25
"d:\GitRepos\ics4-final-project-ibihaqs\src\main\java\engine\renderer\Renderer.java", "Java", 0, 11, 3, 1, 15
"d:\GitRepos\ics4-final-project-ibihaqs\src\main\java\engine\renderer\Shader.java", "Java", 0, -10, 0, -2, -12
"d:\GitRepos\ics4-final-project-ibihaqs\src\main\java\engine\renderer\Sprite.java", "Java", 0, 0, 17, 1, 18
"d:\GitRepos\ics4-final-project-ibihaqs\src\main\java\engine\renderer\SpriteMap.java", "Java", 0, 0, 29, 0, 29
"d:\GitRepos\ics4-final-project-ibihaqs\src\main\java\engine\renderer\Texture.java", "Java", 0, 0, 41, 1, 42
"d:\GitRepos\ics4-final-project-ibihaqs\src\main\java\engine\renderer\VAO.java", "Java", 0, 1, 3, 1, 5
"d:\GitRepos\ics4-final-project-ibihaqs\src\main\java\engine\scenes\Scene.java", "Java", 0, -1, 0, 0, -1
"d:\GitRepos\ics4-final-project-ibihaqs\src\main\java\engine\scenes\SceneManager.java", "Java", 0, 2, 0, 1, 3
"d:\GitRepos\ics4-final-project-ibihaqs\src\main\java\engine\util\Time.java", "Java", 0, 0, 11, 1, 12
"d:\GitRepos\ics4-final-project-ibihaqs\src\main\java\physics\Collision.java", "Java", 0, 59, 51, 32, 142
"d:\GitRepos\ics4-final-project-ibihaqs\src\main\java\physics\Move.java", "Java", 0, 40, 29, 47, 116
"d:\GitRepos\ics4-final-project-ibihaqs\src\main\java\pocketplanets\TestScene.java", "Java", 0, 0, 25, 6, 31
"Total", "-", -4, 161, 676, 176, 1009