"filename", "language", "GLSL", "Java", "XML", "comment", "blank", "total"
"d:\GitRepos\ics4-final-project-ibihaqs\assets\shaders\default.glsl", "GLSL", 22, 0, 0, 0, 10, 32
"d:\GitRepos\ics4-final-project-ibihaqs\pom.xml", "XML", 0, 0, 90, 0, 7, 97
"d:\GitRepos\ics4-final-project-ibihaqs\src\main\java\engine\AssetManager.java", "Java", 0, 15, 0, 18, 8, 41
"d:\GitRepos\ics4-final-project-ibihaqs\src\main\java\engine\Inputs\BoolState.java", "Java", 0, 28, 0, 34, 13, 75
"d:\GitRepos\ics4-final-project-ibihaqs\src\main\java\engine\Inputs\Input.java", "Java", 0, 159, 0, 49, 15, 223
"d:\GitRepos\ics4-final-project-ibihaqs\src\main\java\engine\Inputs\InputAxis.java", "Java", 0, 79, 0, 86, 18, 183
"d:\GitRepos\ics4-final-project-ibihaqs\src\main\java\engine\Inputs\KeyListener.java", "Java", 0, 38, 0, 55, 12, 105
"d:\GitRepos\ics4-final-project-ibihaqs\src\main\java\engine\Inputs\MouseListener.java", "Java", 0, 57, 0, 62, 25, 144
"d:\GitRepos\ics4-final-project-ibihaqs\src\main\java\engine\Main.java", "Java", 0, 7, 0, 0, 1, 8
"d:\GitRepos\ics4-final-project-ibihaqs\src\main\java\engine\Window.java", "Java", 0, 140, 0, 13, 50, 203
"d:\GitRepos\ics4-final-project-ibihaqs\src\main\java\engine\components\Component.java", "Java", 0, 9, 0, 3, 7, 19
"d:\GitRepos\ics4-final-project-ibihaqs\src\main\java\engine\components\KeyboardControl.java", "Java", 0, 15, 0, 0, 8, 23
"d:\GitRepos\ics4-final-project-ibihaqs\src\main\java\engine\components\Renderable.java", "Java", 0, 49, 0, 1, 19, 69
"d:\GitRepos\ics4-final-project-ibihaqs\src\main\java\engine\components\SpriteRenderer.java", "Java", 0, 39, 0, 18, 17, 74
"d:\GitRepos\ics4-final-project-ibihaqs\src\main\java\engine\components\Transform.java", "Java", 0, 46, 0, 0, 15, 61
"d:\GitRepos\ics4-final-project-ibihaqs\src\main\java\engine\events\EventListener.java", "Java", 0, 3, 0, 0, 3, 6
"d:\GitRepos\ics4-final-project-ibihaqs\src\main\java\engine\events\EventTrigger.java", "Java", 0, 30, 0, 4, 15, 49
"d:\GitRepos\ics4-final-project-ibihaqs\src\main\java\engine\gameobjects\GameObject.java", "Java", 0, 63, 0, 59, 16, 138
"d:\GitRepos\ics4-final-project-ibihaqs\src\main\java\engine\geometry\Circle.java", "Java", 0, 25, 0, 28, 29, 82
"d:\GitRepos\ics4-final-project-ibihaqs\src\main\java\engine\geometry\Quad.java", "Java", 0, 38, 0, 22, 34, 94
"d:\GitRepos\ics4-final-project-ibihaqs\src\main\java\engine\physics\Collision.java", "Java", 0, 0, 0, 109, 32, 141
"d:\GitRepos\ics4-final-project-ibihaqs\src\main\java\engine\renderer\Camera.java", "Java", 0, 31, 0, 0, 10, 41
"d:\GitRepos\ics4-final-project-ibihaqs\src\main\java\engine\renderer\EBO.java", "Java", 0, 23, 0, 1, 9, 33
"d:\GitRepos\ics4-final-project-ibihaqs\src\main\java\engine\renderer\Layer.java", "Java", 0, 30, 0, 13, 12, 55
"d:\GitRepos\ics4-final-project-ibihaqs\src\main\java\engine\renderer\RenderBatch.java", "Java", 0, 92, 0, 11, 42, 145
"d:\GitRepos\ics4-final-project-ibihaqs\src\main\java\engine\renderer\Renderer.java", "Java", 0, 51, 0, 3, 18, 72
"d:\GitRepos\ics4-final-project-ibihaqs\src\main\java\engine\renderer\Shader.java", "Java", 0, 143, 0, 12, 41, 196
"d:\GitRepos\ics4-final-project-ibihaqs\src\main\java\engine\renderer\Sprite.java", "Java", 0, 10, 0, 17, 5, 32
"d:\GitRepos\ics4-final-project-ibihaqs\src\main\java\engine\renderer\SpriteMap.java", "Java", 0, 27, 0, 29, 11, 67
"d:\GitRepos\ics4-final-project-ibihaqs\src\main\java\engine\renderer\Texture.java", "Java", 0, 50, 0, 44, 23, 117
"d:\GitRepos\ics4-final-project-ibihaqs\src\main\java\engine\renderer\VAO.java", "Java", 0, 52, 0, 6, 21, 79
"d:\GitRepos\ics4-final-project-ibihaqs\src\main\java\engine\scenes\Scene.java", "Java", 0, 29, 0, 0, 10, 39
"d:\GitRepos\ics4-final-project-ibihaqs\src\main\java\engine\scenes\SceneManager.java", "Java", 0, 44, 0, 0, 16, 60
"d:\GitRepos\ics4-final-project-ibihaqs\src\main\java\engine\util\Time.java", "Java", 0, 6, 0, 11, 4, 21
"d:\GitRepos\ics4-final-project-ibihaqs\src\main\java\physics\Collision.java", "Java", 0, 59, 0, 51, 32, 142
"d:\GitRepos\ics4-final-project-ibihaqs\src\main\java\physics\Move.java", "Java", 0, 40, 0, 29, 47, 116
"d:\GitRepos\ics4-final-project-ibihaqs\src\main\java\pocketplanets\Planet.java", "Java", 0, 15, 0, 0, 11, 26
"d:\GitRepos\ics4-final-project-ibihaqs\src\main\java\pocketplanets\Resource.java", "Java", 0, 24, 0, 0, 9, 33
"d:\GitRepos\ics4-final-project-ibihaqs\src\main\java\pocketplanets\Stats.java", "Java", 0, 3, 0, 0, 3, 6
"d:\GitRepos\ics4-final-project-ibihaqs\src\main\java\pocketplanets\TestScene.java", "Java", 0, 0, 0, 25, 6, 31
"d:\GitRepos\ics4-final-project-ibihaqs\src\main\java\pocketplanets\buildings\Building.java", "Java", 0, 13, 0, 1, 12, 26
"d:\GitRepos\ics4-final-project-ibihaqs\src\main\java\pocketplanets\buildings\CityBuilding.java", "Java", 0, 6, 0, 3, 4, 13
"d:\GitRepos\ics4-final-project-ibihaqs\src\main\java\pocketplanets\buildings\ExtractorBuilding.java", "Java", 0, 32, 0, 1, 17, 50
"d:\GitRepos\ics4-final-project-ibihaqs\src\main\java\pocketplanets\buildings\FuelStationBuilding.java", "Java", 0, 8, 0, 1, 4, 13
"d:\GitRepos\ics4-final-project-ibihaqs\src\main\java\pocketplanets\buildings\ShipyardBuilding.java", "Java", 0, 8, 0, 1, 4, 13
"d:\GitRepos\ics4-final-project-ibihaqs\src\main\java\pocketplanets\ships\BuilderShip.java", "Java", 0, 8, 0, 5, 6, 19
"d:\GitRepos\ics4-final-project-ibihaqs\src\main\java\pocketplanets\ships\CargoShip.java", "Java", 0, 19, 0, 14, 12, 45
"d:\GitRepos\ics4-final-project-ibihaqs\src\main\java\pocketplanets\ships\ScoutShip.java", "Java", 0, 9, 0, 5, 7, 21
"d:\GitRepos\ics4-final-project-ibihaqs\src\main\java\pocketplanets\ships\Ship.java", "Java", 0, 46, 0, 33, 29, 108
"Total", "-", 22, 1718, 90, 877, 779, 3486