"filename", "language", "Java", "XML", "GLSL", "comment", "blank", "total"
"d:\Git Repos\ics4-final-project-ibihaqs\src\main\java\engine\AssetManager.java", "Java", -23, 0, 0, -21, -11, -55
"d:\Git Repos\ics4-final-project-ibihaqs\src\main\java\engine\Inputs\ButtonState.java", "Java", -28, 0, 0, -34, -13, -75
"d:\Git Repos\ics4-final-project-ibihaqs\src\main\java\engine\Inputs\Input.java", "Java", -228, 0, 0, -74, -33, -335
"d:\Git Repos\ics4-final-project-ibihaqs\src\main\java\engine\Inputs\InputAxis.java", "Java", -79, 0, 0, -86, -17, -182
"d:\Git Repos\ics4-final-project-ibihaqs\src\main\java\engine\Inputs\KeyListener.java", "Java", -27, 0, 0, -45, -10, -82
"d:\Git Repos\ics4-final-project-ibihaqs\src\main\java\engine\Inputs\MouseListener.java", "Java", -57, 0, 0, -55, -25, -137
"d:\Git Repos\ics4-final-project-ibihaqs\src\main\java\engine\Main.java", "Java", -15, 0, 0, 0, -10, -25
"d:\Git Repos\ics4-final-project-ibihaqs\src\main\java\engine\Window.java", "Java", -101, 0, 0, -48, -55, -204
"d:\Git Repos\ics4-final-project-ibihaqs\src\main\java\engine\components\Component.java", "Java", -11, 0, 0, -39, -12, -62
"d:\Git Repos\ics4-final-project-ibihaqs\src\main\java\engine\components\KeyboardControl.java", "Java", -15, 0, 0, -2, -8, -25
"d:\Git Repos\ics4-final-project-ibihaqs\src\main\java\engine\components\LineRenderer.java", "Java", -109, 0, 0, -68, -45, -222
"d:\Git Repos\ics4-final-project-ibihaqs\src\main\java\engine\components\PanelRenderer.java", "Java", 0, 0, 0, -65, -24, -89
"d:\Git Repos\ics4-final-project-ibihaqs\src\main\java\engine\components\Renderable.java", "Java", -40, 0, 0, -36, -18, -94
"d:\Git Repos\ics4-final-project-ibihaqs\src\main\java\engine\components\SpriteRenderer.java", "Java", -53, 0, 0, -21, -20, -94
"d:\Git Repos\ics4-final-project-ibihaqs\src\main\java\engine\components\Transform.java", "Java", -166, 0, 0, -98, -53, -317
"d:\Git Repos\ics4-final-project-ibihaqs\src\main\java\engine\events\EventListener.java", "Java", 0, 0, 0, -3, -3, -6
"d:\Git Repos\ics4-final-project-ibihaqs\src\main\java\engine\events\EventTrigger.java", "Java", 0, 0, 0, -34, -15, -49
"d:\Git Repos\ics4-final-project-ibihaqs\src\main\java\engine\gameobjects\GameObject.java", "Java", -80, 0, 0, -88, -22, -190
"d:\Git Repos\ics4-final-project-ibihaqs\src\main\java\engine\geometry\Circle.java", "Java", -25, 0, 0, -28, -29, -82
"d:\Git Repos\ics4-final-project-ibihaqs\src\main\java\engine\geometry\Quad.java", "Java", -47, 0, 0, -22, -25, -94
"d:\Git Repos\ics4-final-project-ibihaqs\src\main\java\engine\physics\Collision.java", "Java", -116, 0, 0, -97, -94, -307
"d:\Git Repos\ics4-final-project-ibihaqs\src\main\java\engine\physics\Move.java", "Java", -57, 0, 0, -39, -53, -149
"d:\Git Repos\ics4-final-project-ibihaqs\src\main\java\engine\renderer\Camera.java", "Java", -47, 0, 0, -20, -18, -85
"d:\Git Repos\ics4-final-project-ibihaqs\src\main\java\engine\renderer\Color.java", "Java", -51, 0, 0, -64, -20, -135
"d:\Git Repos\ics4-final-project-ibihaqs\src\main\java\engine\renderer\EBOFormat.java", "Java", -46, 0, 0, -37, -15, -98
"d:\Git Repos\ics4-final-project-ibihaqs\src\main\java\engine\renderer\Layer.java", "Java", -27, 0, 0, -15, -9, -51
"d:\Git Repos\ics4-final-project-ibihaqs\src\main\java\engine\renderer\RenderBatch.java", "Java", -93, 0, 0, -59, -38, -190
"d:\Git Repos\ics4-final-project-ibihaqs\src\main\java\engine\renderer\Renderer.java", "Java", -53, 0, 0, -46, -20, -119
"d:\Git Repos\ics4-final-project-ibihaqs\src\main\java\engine\renderer\Shader.java", "Java", -150, 0, 0, -70, -42, -262
"d:\Git Repos\ics4-final-project-ibihaqs\src\main\java\engine\renderer\Sprite.java", "Java", -10, 0, 0, -17, -5, -32
"d:\Git Repos\ics4-final-project-ibihaqs\src\main\java\engine\renderer\SpriteMap.java", "Java", -27, 0, 0, -29, -11, -67
"d:\Git Repos\ics4-final-project-ibihaqs\src\main\java\engine\renderer\Texture.java", "Java", -74, 0, 0, -74, -32, -180
"d:\Git Repos\ics4-final-project-ibihaqs\src\main\java\engine\renderer\VAO.java", "Java", -75, 0, 0, -47, -22, -144
"d:\Git Repos\ics4-final-project-ibihaqs\src\main\java\engine\renderer\VBO.java", "Java", -29, 0, 0, -26, -15, -70
"d:\Git Repos\ics4-final-project-ibihaqs\src\main\java\engine\scenes\Scene.java", "Java", -44, 0, 0, -45, -13, -102
"d:\Git Repos\ics4-final-project-ibihaqs\src\main\java\engine\scenes\SceneManager.java", "Java", -54, 0, 0, -48, -18, -120
"d:\Git Repos\ics4-final-project-ibihaqs\src\main\java\engine\serializer\SaveStates.java", "Java", -53, 0, 0, -17, -52, -122
"d:\Git Repos\ics4-final-project-ibihaqs\src\main\java\engine\util\Time.java", "Java", -6, 0, 0, -11, -4, -21
"d:\GitRepos\ics4-final-project-ibihaqs\assets\shaders\default.glsl", "GLSL", 0, 0, 22, 0, 10, 32
"d:\GitRepos\ics4-final-project-ibihaqs\assets\shaders\multitex.glsl", "GLSL", 0, 0, 53, 0, 15, 68
"d:\GitRepos\ics4-final-project-ibihaqs\assets\shaders\panel.glsl", "GLSL", 0, 0, 26, 0, 9, 35
"d:\GitRepos\ics4-final-project-ibihaqs\pom.xml", "XML", 0, 90, 0, 0, 7, 97
"d:\GitRepos\ics4-final-project-ibihaqs\src\main\java\demo\Demo.java", "Java", 35, 0, 0, 1, 9, 45
"d:\GitRepos\ics4-final-project-ibihaqs\src\main\java\demo\components\Ball.java", "Java", 72, 0, 0, 11, 21, 104
"d:\GitRepos\ics4-final-project-ibihaqs\src\main\java\demo\components\ConstantSpin.java", "Java", 18, 0, 0, 0, 8, 26
"d:\GitRepos\ics4-final-project-ibihaqs\src\main\java\demo\components\KeyMover.java", "Java", 27, 0, 0, 7, 10, 44
"d:\GitRepos\ics4-final-project-ibihaqs\src\main\java\demo\components\Paddle.java", "Java", 40, 0, 0, 0, 13, 53
"d:\GitRepos\ics4-final-project-ibihaqs\src\main\java\demo\components\Player.java", "Java", 90, 0, 0, 17, 54, 161
"d:\GitRepos\ics4-final-project-ibihaqs\src\main\java\demo\components\RandomMovement.java", "Java", 21, 0, 0, 5, 14, 40
"d:\GitRepos\ics4-final-project-ibihaqs\src\main\java\demo\components\Weapon.java", "Java", 73, 0, 0, 2, 20, 95
"d:\GitRepos\ics4-final-project-ibihaqs\src\main\java\demo\scenes\ColorScene.java", "Java", 63, 0, 0, 0, 13, 76
"d:\GitRepos\ics4-final-project-ibihaqs\src\main\java\demo\scenes\GrapplingGameScene.java", "Java", 151, 0, 0, 16, 46, 213
"d:\GitRepos\ics4-final-project-ibihaqs\src\main\java\demo\scenes\MultipleBatches.java", "Java", 66, 0, 0, 0, 16, 82
"d:\GitRepos\ics4-final-project-ibihaqs\src\main\java\demo\scenes\MultipleRenderTypes.java", "Java", 4, 0, 0, 0, 4, 8
"d:\GitRepos\ics4-final-project-ibihaqs\src\main\java\demo\scenes\MultipleTexturesScene.java", "Java", 4, 0, 0, 0, 4, 8
"d:\GitRepos\ics4-final-project-ibihaqs\src\main\java\demo\scenes\OrbitalScene.java", "Java", 82, 0, 0, 0, 14, 96
"d:\GitRepos\ics4-final-project-ibihaqs\src\main\java\demo\scenes\PongGameScene.java", "Java", 100, 0, 0, 3, 28, 131
"d:\GitRepos\ics4-final-project-ibihaqs\src\main\java\demo\scenes\SingleScene.java", "Java", 50, 0, 0, 0, 11, 61
"d:\GitRepos\ics4-final-project-ibihaqs\src\main\java\engine\AssetManager.java", "Java", 23, 0, 0, 21, 11, 55
"d:\GitRepos\ics4-final-project-ibihaqs\src\main\java\engine\Inputs\ButtonState.java", "Java", 28, 0, 0, 34, 13, 75
"d:\GitRepos\ics4-final-project-ibihaqs\src\main\java\engine\Inputs\Input.java", "Java", 228, 0, 0, 74, 33, 335
"d:\GitRepos\ics4-final-project-ibihaqs\src\main\java\engine\Inputs\InputAxis.java", "Java", 79, 0, 0, 86, 17, 182
"d:\GitRepos\ics4-final-project-ibihaqs\src\main\java\engine\Inputs\KeyListener.java", "Java", 27, 0, 0, 45, 10, 82
"d:\GitRepos\ics4-final-project-ibihaqs\src\main\java\engine\Inputs\MouseListener.java", "Java", 57, 0, 0, 55, 25, 137
"d:\GitRepos\ics4-final-project-ibihaqs\src\main\java\engine\Window.java", "Java", 132, 0, 0, 50, 59, 241
"d:\GitRepos\ics4-final-project-ibihaqs\src\main\java\engine\components\Component.java", "Java", 11, 0, 0, 39, 12, 62
"d:\GitRepos\ics4-final-project-ibihaqs\src\main\java\engine\components\FollowMouse.java", "Java", 20, 0, 0, 5, 8, 33
"d:\GitRepos\ics4-final-project-ibihaqs\src\main\java\engine\components\KeyboardControl.java", "Java", 15, 0, 0, 2, 8, 25
"d:\GitRepos\ics4-final-project-ibihaqs\src\main\java\engine\components\LineRenderer.java", "Java", 109, 0, 0, 68, 45, 222
"d:\GitRepos\ics4-final-project-ibihaqs\src\main\java\engine\components\PanelRenderer.java", "Java", 0, 0, 0, 65, 24, 89
"d:\GitRepos\ics4-final-project-ibihaqs\src\main\java\engine\components\Renderable.java", "Java", 40, 0, 0, 36, 18, 94
"d:\GitRepos\ics4-final-project-ibihaqs\src\main\java\engine\components\SpriteRenderer.java", "Java", 74, 0, 0, 38, 27, 139
"d:\GitRepos\ics4-final-project-ibihaqs\src\main\java\engine\components\Transform.java", "Java", 155, 0, 0, 110, 53, 318
"d:\GitRepos\ics4-final-project-ibihaqs\src\main\java\engine\events\EventListener.java", "Java", 0, 0, 0, 3, 3, 6
"d:\GitRepos\ics4-final-project-ibihaqs\src\main\java\engine\events\EventTrigger.java", "Java", 0, 0, 0, 34, 15, 49
"d:\GitRepos\ics4-final-project-ibihaqs\src\main\java\engine\gameobjects\GameObject.java", "Java", 80, 0, 0, 88, 22, 190
"d:\GitRepos\ics4-final-project-ibihaqs\src\main\java\engine\geometry\Circle.java", "Java", 25, 0, 0, 28, 29, 82
"d:\GitRepos\ics4-final-project-ibihaqs\src\main\java\engine\geometry\Quad.java", "Java", 47, 0, 0, 22, 25, 94
"d:\GitRepos\ics4-final-project-ibihaqs\src\main\java\engine\physics\Collision.java", "Java", 133, 0, 0, 99, 100, 332
"d:\GitRepos\ics4-final-project-ibihaqs\src\main\java\engine\physics\Move.java", "Java", 60, 0, 0, 42, 56, 158
"d:\GitRepos\ics4-final-project-ibihaqs\src\main\java\engine\renderer\Camera.java", "Java", 47, 0, 0, 20, 18, 85
"d:\GitRepos\ics4-final-project-ibihaqs\src\main\java\engine\renderer\Color.java", "Java", 51, 0, 0, 64, 19, 134
"d:\GitRepos\ics4-final-project-ibihaqs\src\main\java\engine\renderer\EBOFormat.java", "Java", 46, 0, 0, 37, 15, 98
"d:\GitRepos\ics4-final-project-ibihaqs\src\main\java\engine\renderer\Layer.java", "Java", 27, 0, 0, 15, 9, 51
"d:\GitRepos\ics4-final-project-ibihaqs\src\main\java\engine\renderer\RenderBatch.java", "Java", 95, 0, 0, 59, 39, 193
"d:\GitRepos\ics4-final-project-ibihaqs\src\main\java\engine\renderer\Renderer.java", "Java", 59, 0, 0, 48, 22, 129
"d:\GitRepos\ics4-final-project-ibihaqs\src\main\java\engine\renderer\Shader.java", "Java", 148, 0, 0, 72, 42, 262
"d:\GitRepos\ics4-final-project-ibihaqs\src\main\java\engine\renderer\Sprite.java", "Java", 10, 0, 0, 17, 5, 32
"d:\GitRepos\ics4-final-project-ibihaqs\src\main\java\engine\renderer\SpriteMap.java", "Java", 27, 0, 0, 29, 11, 67
"d:\GitRepos\ics4-final-project-ibihaqs\src\main\java\engine\renderer\Texture.java", "Java", 74, 0, 0, 74, 32, 180
"d:\GitRepos\ics4-final-project-ibihaqs\src\main\java\engine\renderer\VAO.java", "Java", 75, 0, 0, 47, 22, 144
"d:\GitRepos\ics4-final-project-ibihaqs\src\main\java\engine\renderer\VBO.java", "Java", 29, 0, 0, 26, 15, 70
"d:\GitRepos\ics4-final-project-ibihaqs\src\main\java\engine\scenes\Scene.java", "Java", 44, 0, 0, 45, 13, 102
"d:\GitRepos\ics4-final-project-ibihaqs\src\main\java\engine\scenes\SceneManager.java", "Java", 64, 0, 0, 61, 22, 147
"d:\GitRepos\ics4-final-project-ibihaqs\src\main\java\engine\serializer\SaveStates.java", "Java", 88, 0, 0, 48, 83, 219
"d:\GitRepos\ics4-final-project-ibihaqs\src\main\java\engine\util\Time.java", "Java", 6, 0, 0, 11, 4, 21
"d:\GitRepos\ics4-final-project-ibihaqs\src\main\java\pocketplanets\Planet.java", "Java", 18, 0, 0, 1, 9, 28
"d:\GitRepos\ics4-final-project-ibihaqs\src\main\java\pocketplanets\Resource.java", "Java", 30, 0, 0, 0, 9, 39
"d:\GitRepos\ics4-final-project-ibihaqs\src\main\java\pocketplanets\buildings\Building.java", "Java", 12, 0, 0, 0, 11, 23
"d:\GitRepos\ics4-final-project-ibihaqs\src\main\java\pocketplanets\buildings\CityBuilding.java", "Java", 5, 0, 0, 3, 4, 12
"d:\GitRepos\ics4-final-project-ibihaqs\src\main\java\pocketplanets\buildings\ExtractorBuilding.java", "Java", 25, 0, 0, 8, 14, 47
"d:\GitRepos\ics4-final-project-ibihaqs\src\main\java\pocketplanets\buildings\FuelStationBuilding.java", "Java", 20, 0, 0, 0, 6, 26
"d:\GitRepos\ics4-final-project-ibihaqs\src\main\java\pocketplanets\buildings\ShipyardBuilding.java", "Java", 7, 0, 0, 1, 4, 12
"d:\GitRepos\ics4-final-project-ibihaqs\src\main\java\pocketplanets\ships\BuilderShip.java", "Java", 8, 0, 0, 5, 6, 19
"d:\GitRepos\ics4-final-project-ibihaqs\src\main\java\pocketplanets\ships\CargoShip.java", "Java", 19, 0, 0, 15, 12, 46
"d:\GitRepos\ics4-final-project-ibihaqs\src\main\java\pocketplanets\ships\ScoutShip.java", "Java", 9, 0, 0, 5, 7, 21
"d:\GitRepos\ics4-final-project-ibihaqs\src\main\java\pocketplanets\ships\Ship.java", "Java", 52, 0, 0, 46, 36, 134
"d:\GitRepos\ics4-final-project-ibihaqs\src\main\java\pocketplanets\testing\BatchingTestScene.java", "Java", 66, 0, 0, 23, 27, 116
"d:\GitRepos\ics4-final-project-ibihaqs\src\main\java\pocketplanets\testing\SampleComponent.java", "Java", 23, 0, 0, 8, 9, 40
"d:\GitRepos\ics4-final-project-ibihaqs\src\main\java\pocketplanets\testing\SampleScene.java", "Java", 0, 0, 0, 90, 22, 112
"d:\GitRepos\ics4-final-project-ibihaqs\src\main\java\pocketplanets\testing\SampleSwinging.java", "Java", 24, 0, 0, 8, 11, 43
"d:\GitRepos\ics4-final-project-ibihaqs\src\main\java\pocketplanets\testing\TestScene.java", "Java", 1, 0, 0, 25, 6, 32
"d:\GitRepos\ics4-final-project-ibihaqs\src\main\java\robinhood\Main.java", "Java", 3, 0, 0, 0, 3, 6
"d:\GitRepos\ics4-final-project-ibihaqs\src\main\java\robinhood\components\Archer.java", "Java", 3, 0, 0, 0, 3, 6
"d:\GitRepos\ics4-final-project-ibihaqs\src\main\java\robinhood\components\Arrow.java", "Java", 3, 0, 0, 0, 3, 6
"d:\GitRepos\ics4-final-project-ibihaqs\src\main\java\robinhood\components\Bow.java", "Java", 3, 0, 0, 0, 3, 6
"d:\GitRepos\ics4-final-project-ibihaqs\src\main\java\robinhood\scenes\RobinhoodGameScene.java", "Java", 58, 0, 0, 3, 15, 76
"Total", "-", 1402, 90, 101, 392, 601, 2586