"filename", "language", "Java", "GLSL", "comment", "blank", "total"
"d:\GitRepos\ics4-final-project-ibihaqs\assets\shaders\default.glsl", "GLSL", 0, -4, 0, 2, -2
"d:\GitRepos\ics4-final-project-ibihaqs\assets\shaders\multitex.glsl", "GLSL", 0, 27, 0, 10, 37
"d:\GitRepos\ics4-final-project-ibihaqs\assets\shaders\panel.glsl", "GLSL", 0, 26, 0, 9, 35
"d:\GitRepos\ics4-final-project-ibihaqs\src\main\java\engine\AssetManager.java", "Java", 23, 0, 21, 11, 55
"d:\GitRepos\ics4-final-project-ibihaqs\src\main\java\engine\Inputs\BoolState.java", "Java", -30, 0, 0, -13, -43
"d:\GitRepos\ics4-final-project-ibihaqs\src\main\java\engine\Inputs\ButtonState.java", "Java", 28, 0, 34, 13, 75
"d:\GitRepos\ics4-final-project-ibihaqs\src\main\java\engine\Inputs\Input.java", "Java", 68, 0, 74, 19, 161
"d:\GitRepos\ics4-final-project-ibihaqs\src\main\java\engine\Inputs\InputAxis.java", "Java", 13, 0, 84, 0, 97
"d:\GitRepos\ics4-final-project-ibihaqs\src\main\java\engine\Inputs\KeyListener.java", "Java", -16, 0, 45, -4, 25
"d:\GitRepos\ics4-final-project-ibihaqs\src\main\java\engine\Inputs\MouseListener.java", "Java", -5, 0, 55, 3, 53
"d:\GitRepos\ics4-final-project-ibihaqs\src\main\java\engine\Main.java", "Java", 8, 0, 0, 8, 16
"d:\GitRepos\ics4-final-project-ibihaqs\src\main\java\engine\Window.java", "Java", -3, 0, -1, 5, 1
"d:\GitRepos\ics4-final-project-ibihaqs\src\main\java\engine\components\Component.java", "Java", 2, 0, 3, 0, 5
"d:\GitRepos\ics4-final-project-ibihaqs\src\main\java\engine\components\ImageRenderer.java", "Java", 38, 0, 0, 17, 55
"d:\GitRepos\ics4-final-project-ibihaqs\src\main\java\engine\components\KeyboardControl.java", "Java", 0, 0, 2, 0, 2
"d:\GitRepos\ics4-final-project-ibihaqs\src\main\java\engine\components\LineRenderer.java", "Java", 82, 0, 10, 31, 123
"d:\GitRepos\ics4-final-project-ibihaqs\src\main\java\engine\components\PanelRenderer.java", "Java", 63, 0, 0, 25, 88
"d:\GitRepos\ics4-final-project-ibihaqs\src\main\java\engine\components\QuadRenderable.java", "Java", 20, 0, 0, 11, 31
"d:\GitRepos\ics4-final-project-ibihaqs\src\main\java\engine\components\Renderable.java", "Java", -6, 0, -1, 2, -5
"d:\GitRepos\ics4-final-project-ibihaqs\src\main\java\engine\components\SpriteGroup.java", "Java", 0, 0, 0, 1, 1
"d:\GitRepos\ics4-final-project-ibihaqs\src\main\java\engine\components\SpriteRenderer.java", "Java", 1, 0, -6, -5, -10
"d:\GitRepos\ics4-final-project-ibihaqs\src\main\java\engine\components\Transform.java", "Java", 48, 0, 21, 19, 88
"d:\GitRepos\ics4-final-project-ibihaqs\src\main\java\engine\gameobjects\GameObject.java", "Java", 17, 0, 36, 0, 53
"d:\GitRepos\ics4-final-project-ibihaqs\src\main\java\engine\geometry\Circle.java", "Java", 25, 0, 28, 29, 82
"d:\GitRepos\ics4-final-project-ibihaqs\src\main\java\engine\geometry\Quad.java", "Java", 22, 0, 22, 18, 62
"d:\GitRepos\ics4-final-project-ibihaqs\src\main\java\engine\physics\Collision.java", "Java", 30, 0, 17, 36, 83
"d:\GitRepos\ics4-final-project-ibihaqs\src\main\java\engine\physics\Move.java", "Java", 48, 0, 36, 52, 136
"d:\GitRepos\ics4-final-project-ibihaqs\src\main\java\engine\renderer\BufferIDs.java", "Java", 14, 0, 0, 4, 18
"d:\GitRepos\ics4-final-project-ibihaqs\src\main\java\engine\renderer\Camera.java", "Java", 20, 0, 2, 9, 31
"d:\GitRepos\ics4-final-project-ibihaqs\src\main\java\engine\renderer\EBO.java", "Java", -24, 0, -1, -9, -34
"d:\GitRepos\ics4-final-project-ibihaqs\src\main\java\engine\renderer\EBOFormat.java", "Java", 46, 0, 3, 13, 62
"d:\GitRepos\ics4-final-project-ibihaqs\src\main\java\engine\renderer\Layer.java", "Java", 9, 0, -3, 4, 10
"d:\GitRepos\ics4-final-project-ibihaqs\src\main\java\engine\renderer\QuadRenderBatch.java", "Java", 37, 0, 6, 16, 59
"d:\GitRepos\ics4-final-project-ibihaqs\src\main\java\engine\renderer\QuadRenderer.java", "Java", 101, 0, 11, 39, 151
"d:\GitRepos\ics4-final-project-ibihaqs\src\main\java\engine\renderer\RenderBatch.java", "Java", 16, 0, 2, 3, 21
"d:\GitRepos\ics4-final-project-ibihaqs\src\main\java\engine\renderer\Renderer.java", "Java", 29, 0, 0, 5, 34
"d:\GitRepos\ics4-final-project-ibihaqs\src\main\java\engine\renderer\Shader.java", "Java", -3, 0, 0, -2, -5
"d:\GitRepos\ics4-final-project-ibihaqs\src\main\java\engine\renderer\Sprite.java", "Java", 0, 0, 17, 1, 18
"d:\GitRepos\ics4-final-project-ibihaqs\src\main\java\engine\renderer\SpriteMap.java", "Java", 0, 0, 29, 0, 29
"d:\GitRepos\ics4-final-project-ibihaqs\src\main\java\engine\renderer\Texture.java", "Java", 24, 0, 41, 9, 74
"d:\GitRepos\ics4-final-project-ibihaqs\src\main\java\engine\renderer\VAO.java", "Java", 24, 0, 3, 5, 32
"d:\GitRepos\ics4-final-project-ibihaqs\src\main\java\engine\renderer\VBO.java", "Java", 31, 0, 0, 15, 46
"d:\GitRepos\ics4-final-project-ibihaqs\src\main\java\engine\scenes\Scene.java", "Java", 15, 0, 0, 2, 17
"d:\GitRepos\ics4-final-project-ibihaqs\src\main\java\engine\scenes\SceneManager.java", "Java", 9, 0, 6, 3, 18
"d:\GitRepos\ics4-final-project-ibihaqs\src\main\java\engine\serializer\SaveStates.java", "Java", 52, 0, 11, 53, 116
"d:\GitRepos\ics4-final-project-ibihaqs\src\main\java\engine\util\Time.java", "Java", 0, 0, 11, 1, 12
"d:\GitRepos\ics4-final-project-ibihaqs\src\main\java\nebula\FollowMouse.java", "Java", 22, 0, 5, 8, 35
"d:\GitRepos\ics4-final-project-ibihaqs\src\main\java\nebula\MainGameScene.java", "Java", 87, 0, 6, 32, 125
"d:\GitRepos\ics4-final-project-ibihaqs\src\main\java\nebula\Player.java", "Java", 54, 0, 1, 19, 74
"d:\GitRepos\ics4-final-project-ibihaqs\src\main\java\nebula\Stats.java", "Java", 4, 0, 0, 2, 6
"d:\GitRepos\ics4-final-project-ibihaqs\src\main\java\pocketplanets\Planet.java", "Java", 3, 0, 1, -2, 2
"d:\GitRepos\ics4-final-project-ibihaqs\src\main\java\pocketplanets\Resource.java", "Java", 6, 0, 0, 0, 6
"d:\GitRepos\ics4-final-project-ibihaqs\src\main\java\pocketplanets\Stats.java", "Java", -3, 0, 0, -3, -6
"d:\GitRepos\ics4-final-project-ibihaqs\src\main\java\pocketplanets\buildings\Building.java", "Java", -1, 0, -1, -1, -3
"d:\GitRepos\ics4-final-project-ibihaqs\src\main\java\pocketplanets\buildings\CityBuilding.java", "Java", -1, 0, 0, 0, -1
"d:\GitRepos\ics4-final-project-ibihaqs\src\main\java\pocketplanets\buildings\ExtractorBuilding.java", "Java", -7, 0, 7, -3, -3
"d:\GitRepos\ics4-final-project-ibihaqs\src\main\java\pocketplanets\buildings\FuelStationBuilding.java", "Java", 12, 0, -1, 2, 13
"d:\GitRepos\ics4-final-project-ibihaqs\src\main\java\pocketplanets\buildings\ShipyardBuilding.java", "Java", -1, 0, 0, 0, -1
"d:\GitRepos\ics4-final-project-ibihaqs\src\main\java\pocketplanets\ships\CargoShip.java", "Java", 0, 0, 1, 0, 1
"d:\GitRepos\ics4-final-project-ibihaqs\src\main\java\pocketplanets\ships\Ship.java", "Java", 8, 0, 12, 7, 27
"d:\GitRepos\ics4-final-project-ibihaqs\src\main\java\pocketplanets\testing\BatchingTestScene.java", "Java", 68, 0, 3, 21, 92
"d:\GitRepos\ics4-final-project-ibihaqs\src\main\java\pocketplanets\testing\SampleComponent.java", "Java", 23, 0, 8, 9, 40
"d:\GitRepos\ics4-final-project-ibihaqs\src\main\java\pocketplanets\testing\SampleScene.java", "Java", 0, 0, 90, 22, 112
"d:\GitRepos\ics4-final-project-ibihaqs\src\main\java\pocketplanets\testing\SampleSwinging.java", "Java", 24, 0, 8, 11, 43
"d:\GitRepos\ics4-final-project-ibihaqs\src\main\java\pocketplanets\testing\TestScene.java", "Java", 1, 0, 25, 6, 32
"Total", "-", 1175, 49, 783, 600, 2607