"filename", "language", "Java", "XML", "GLSL", "comment", "blank", "total"
"d:\GitRepos\ics4-final-project-ibihaqs\assets\shaders\default.glsl", "GLSL", 0, 0, 26, 0, 8, 34
"d:\GitRepos\ics4-final-project-ibihaqs\pom.xml", "XML", 0, 90, 0, 0, 7, 97
"d:\GitRepos\ics4-final-project-ibihaqs\src\main\java\engine\Inputs\BoolState.java", "Java", 30, 0, 0, 0, 13, 43
"d:\GitRepos\ics4-final-project-ibihaqs\src\main\java\engine\Inputs\Input.java", "Java", 160, 0, 0, 0, 14, 174
"d:\GitRepos\ics4-final-project-ibihaqs\src\main\java\engine\Inputs\InputAxis.java", "Java", 66, 0, 0, 2, 17, 85
"d:\GitRepos\ics4-final-project-ibihaqs\src\main\java\engine\Inputs\KeyListener.java", "Java", 43, 0, 0, 0, 14, 57
"d:\GitRepos\ics4-final-project-ibihaqs\src\main\java\engine\Inputs\MouseListener.java", "Java", 62, 0, 0, 0, 22, 84
"d:\GitRepos\ics4-final-project-ibihaqs\src\main\java\engine\Main.java", "Java", 7, 0, 0, 0, 1, 8
"d:\GitRepos\ics4-final-project-ibihaqs\src\main\java\engine\Window.java", "Java", 104, 0, 0, 16, 41, 161
"d:\GitRepos\ics4-final-project-ibihaqs\src\main\java\engine\components\Component.java", "Java", 9, 0, 0, 0, 7, 16
"d:\GitRepos\ics4-final-project-ibihaqs\src\main\java\engine\components\KeyboardControl.java", "Java", 15, 0, 0, 0, 8, 23
"d:\GitRepos\ics4-final-project-ibihaqs\src\main\java\engine\components\Renderable.java", "Java", 45, 0, 0, 1, 16, 62
"d:\GitRepos\ics4-final-project-ibihaqs\src\main\java\engine\components\SpriteRenderer.java", "Java", 38, 0, 0, 10, 20, 68
"d:\GitRepos\ics4-final-project-ibihaqs\src\main\java\engine\components\Transform.java", "Java", 44, 0, 0, 0, 14, 58
"d:\GitRepos\ics4-final-project-ibihaqs\src\main\java\engine\events\EventListener.java", "Java", 3, 0, 0, 0, 3, 6
"d:\GitRepos\ics4-final-project-ibihaqs\src\main\java\engine\events\EventTrigger.java", "Java", 30, 0, 0, 4, 15, 49
"d:\GitRepos\ics4-final-project-ibihaqs\src\main\java\engine\gameobjects\GameObject.java", "Java", 63, 0, 0, 23, 20, 106
"d:\GitRepos\ics4-final-project-ibihaqs\src\main\java\engine\geometry\Quad.java", "Java", 25, 0, 0, 0, 7, 32
"d:\GitRepos\ics4-final-project-ibihaqs\src\main\java\engine\physics\Collision.java", "Java", 58, 0, 0, 51, 32, 141
"d:\GitRepos\ics4-final-project-ibihaqs\src\main\java\engine\renderer\Camera.java", "Java", 31, 0, 0, 0, 10, 41
"d:\GitRepos\ics4-final-project-ibihaqs\src\main\java\engine\renderer\EBO.java", "Java", 24, 0, 0, 1, 9, 34
"d:\GitRepos\ics4-final-project-ibihaqs\src\main\java\engine\renderer\Layer.java", "Java", 22, 0, 0, 3, 8, 33
"d:\GitRepos\ics4-final-project-ibihaqs\src\main\java\engine\renderer\RenderBatch.java", "Java", 78, 0, 0, 8, 34, 120
"d:\GitRepos\ics4-final-project-ibihaqs\src\main\java\engine\renderer\Renderer.java", "Java", 40, 0, 0, 0, 17, 57
"d:\GitRepos\ics4-final-project-ibihaqs\src\main\java\engine\renderer\Shader.java", "Java", 153, 0, 0, 12, 43, 208
"d:\GitRepos\ics4-final-project-ibihaqs\src\main\java\engine\renderer\Sprite.java", "Java", 10, 0, 0, 0, 4, 14
"d:\GitRepos\ics4-final-project-ibihaqs\src\main\java\engine\renderer\SpriteMap.java", "Java", 27, 0, 0, 0, 11, 38
"d:\GitRepos\ics4-final-project-ibihaqs\src\main\java\engine\renderer\Texture.java", "Java", 50, 0, 0, 3, 22, 75
"d:\GitRepos\ics4-final-project-ibihaqs\src\main\java\engine\renderer\VAO.java", "Java", 51, 0, 0, 3, 20, 74
"d:\GitRepos\ics4-final-project-ibihaqs\src\main\java\engine\scenes\Scene.java", "Java", 30, 0, 0, 0, 10, 40
"d:\GitRepos\ics4-final-project-ibihaqs\src\main\java\engine\scenes\SceneManager.java", "Java", 42, 0, 0, 0, 15, 57
"d:\GitRepos\ics4-final-project-ibihaqs\src\main\java\engine\util\Time.java", "Java", 6, 0, 0, 0, 3, 9
"d:\GitRepos\ics4-final-project-ibihaqs\src\main\java\pocketplanets\Planet.java", "Java", 15, 0, 0, 0, 11, 26
"d:\GitRepos\ics4-final-project-ibihaqs\src\main\java\pocketplanets\Resource.java", "Java", 24, 0, 0, 0, 9, 33
"d:\GitRepos\ics4-final-project-ibihaqs\src\main\java\pocketplanets\Stats.java", "Java", 3, 0, 0, 0, 3, 6
"d:\GitRepos\ics4-final-project-ibihaqs\src\main\java\pocketplanets\buildings\Building.java", "Java", 13, 0, 0, 1, 12, 26
"d:\GitRepos\ics4-final-project-ibihaqs\src\main\java\pocketplanets\buildings\CityBuilding.java", "Java", 6, 0, 0, 3, 4, 13
"d:\GitRepos\ics4-final-project-ibihaqs\src\main\java\pocketplanets\buildings\ExtractorBuilding.java", "Java", 32, 0, 0, 1, 17, 50
"d:\GitRepos\ics4-final-project-ibihaqs\src\main\java\pocketplanets\buildings\FuelStationBuilding.java", "Java", 8, 0, 0, 1, 4, 13
"d:\GitRepos\ics4-final-project-ibihaqs\src\main\java\pocketplanets\buildings\ShipyardBuilding.java", "Java", 8, 0, 0, 1, 4, 13
"d:\GitRepos\ics4-final-project-ibihaqs\src\main\java\pocketplanets\ships\BuilderShip.java", "Java", 8, 0, 0, 5, 6, 19
"d:\GitRepos\ics4-final-project-ibihaqs\src\main\java\pocketplanets\ships\CargoShip.java", "Java", 19, 0, 0, 14, 12, 45
"d:\GitRepos\ics4-final-project-ibihaqs\src\main\java\pocketplanets\ships\ScoutShip.java", "Java", 9, 0, 0, 5, 7, 21
"d:\GitRepos\ics4-final-project-ibihaqs\src\main\java\pocketplanets\ships\Ship.java", "Java", 46, 0, 0, 33, 29, 108
"Total", "-", 1557, 90, 26, 201, 603, 2477